NO ./textures/north_texture
SO ./textures/south_texture
WE ./textures/west_texture
EA ./textures/east_texture

F 220,100,35
C 225,30,0

        1111111111
        10000000011
11111111100000000101
100000000N000000011
100000000000011111
10000000000001
11111111111111
