NO ./textures/north_texture
SO ./textures/south_texture
WE ./textures/west_texture
EA ./textures/east_texture

F 220,100,0
C 225,30,0

11111111111111111111111111111111111111111111111111
10000000000000000000000000000000000000000000000001
10000000000000000000000000000000000000000000000001
10000N00000000000000000000000000000000000000000001
10000000011111111111111111111111111111111000000001
1000000001                              1000000001
1000000001                              1000000001
1000000001                              1000000001
1000000001                              1000000001
1000000001                              1000000001
1000000001                              1000000001
1000000001                              1000000001
1000000001                              1000000001
10000000011111111111111111111111111111111000000001
10000000000000000000000000000000000000000000000001
10000000000000000000000000000000000000000000000001
10000000000000000000000000000000000000000000000001
11111111111111111111111111111111111111111111111111
