NO ./textures/wall_brick_north.xpm
SO ./textures/wall_brick_south.xpm
WE ./textures/wall_brick_west.xpm
EA ./textures/wall_brick_east.xpm
F 128,128,128
C 85,91,97

11111111
10100001
10100001
10100N01
10000001
10000101
10000001
11111111
