NO ./textures/wall_brick.xpm
SO ./textures/wall_brick.xpm
WE ./textures/wall_brick.xpm
EA ./textures/wall_brick.xpm

F 128,128,128
C 85,91,97

1111111111111111111111111111111111111111111111111111111111111111111111111111111
1000000000000000000000000000000000000000000000000000000000000000000000000000001
10N0000000000000000000000000000000000000000000000000000000000000000000000000001
100001001000100010001000100010001000100010001000100010001000100010001000100011
1000000000000000000000000000000000000000000000000000000000000000000000000000001
110010001010001000100010001000100010001000100010001000100010001000100010001011
1000000000000000000000000000000000000000000000000000000000000000000000000000001
10000010001000100010001000100010001000100010001000100010001000100010001000100011
100000000000000000000000000000000000000000000000000000000000000000000000000001
101000100010001000100010001000100010001000100010001000100010001000100010001011
100000000000000000000000000000000000000000000000000000000000000000000000000001
10010001000100010001000100010001000100010001000100010001000100010001000100011
100000000000000000000000000000000000000000000000000000000000000000000000000001
101000100010001000100010001000100010001000100010001000100010001000100010001011
1000000000000000000000000000000000000000000000000000000000000000000000000000001
10000010001000100010001000100010001000100010001000100010001000100010001000100011
100001001000100010001000100010001000100010001000100010001000100010001000100011
1000000000000000000000000000000000000000000000000000000000000000000000000000001
110010001010001000100010001000100010001000100010001000100010001000100010001011
1000000000000000000000000000000000000000000000000000000000000000000000000000001
10000010001000100010001000100010001000100010001000100010001000100010001000100011
100000000000000000000000000000000000000000000000000000000000000000000000000001
101000100010001000100010001000100010001000100010001000100010001000100010001011
100000000000000000000000000000000000000000000000000000000000000000000000000001
10010001000100010001000100010001000100010001000100010001000100010001000100011
100000000000000000000000000000000000000000000000000000000000000000000000000001
101000100010001000100010001000100010001000100010001000100010001000100010001011
1000000000000000000000000000000000000000000000000000000000000000000000000000001
10000010001000100010001000100010001000100010001000100010001000100010001000100011
1111111111111111111111111111111111111111111111111111111111111111111111111111111
