NO                                      ./textures/north_texture
SO                                                              	./textures/south_texture
WE 		 	 	./textures/west_texture
EA 		 	 		 ./textures/east_texture

F 		 	220,100,0
C 	 	 	225,30,0

1111111111111111111111111111111111111111111111111111111111111111111111111111111
1E00000111111111111111111111111111111111111111111110000000111111100000000000001
1111110000000000000000000000000000000000000111111111111110111111111101111111101
1111110111111111111111111111111111111111110111111111111110111111111101111111101
1110000111111000000111100011111111111111110000000111111110111111111101111111101
1110111111111011110111101011111111111111110111110111111000000111111101111111101
1110000000000011110111101011111111111111110111110111111011110111111101111111101
1110111111111111110111101011111111111111110111110111111011110111111101111111101
1110111111111111111111101011111111000000000111110111111011110111111101111111101
1110000000000000000000001011111111011111110111110111111011110111011101111111101
1111111111111101111111111011111111011111110111110111111011110111011101111111101
1111111111111101111111111011111111011111110111110111111011110111011101111111101
1111111111111101111111111011111111011111110111111111111011110000011101111111101
1111111111111101111111111011111111111111110111111111111011111111111101111111101
1111111111111101111111111011111111111111110000000000000000000000011101111111101
1111111111111101111111111011111111111111111111111111111111111111011101111111101
1111111111111101111111111000000000000000000000000000000000000011011101111111101
1111111111111101111111111111110111111111111111111110111111111011011101111111101
1111111100000001111111111111110111111111111110000110111111111011011101111111101
1111111101111111111111111111110000000000001110110110111111111011011101111111101
1111111101111111111111111111111111111111101110111110111111111011111101111111101
1111111111111111111111111111110000000000001110000000111111111000000001111111101
1111111111111111111111111111111111111111111111111111111111111111111111111111111
