NO ./textures/wall_brick.xpm
SO ./textures/wall_brick.xpm
WE ./textures/wall_brick.xpm
EA ./textures/wall_brick.xpm
F 128,128,128
C 85,91,97

1111111111111111111111111111111111
1E00000111111111111111111111111111
1111110000000000000000000000000001
1111110111111111111111111111111101
1110000111111000000111100011110001
1110111111111011110111101011110111
1110000000000011110111101011110001
1110111111111111110111101011111111
1110111111111111111111101011111111
1110000000000000000000001011111111
1111111111111101111111111011111111
1111111111111101111111111011111111
1111111111111101111111111011111111
1111111111111101111111111011111111
1111111111111101111111111011111111
1111111111111101111111111011111111
1111111111111101111111111000000001
1111111111111101111111111111110111
1111111100000001111111111111110111
1111111101111111111111111111110001
1111111101111111111111111111111111
1111111111111111111111111111110001
1111111111111111111111111111111111
